general #0	SEABEE / REGISTRY / CERP / RTC / ATTN / POUCH / INVOICE / OIC / WHEREABOUTS / AIRGRAM
general #1	EMBASSY / REF / TEAM / REQUEST / OFFICE / STATE / POST / STAFF / VISIT / SUBJECT
general #2	US / EMBASSY / TRADE / COMMERCIAL / VISIT / GROUP / LIST / FAIR / HOST / PARTICIPATE
general #3	DEVELOPMENT / US / COOPERATION / SPANISH / POSITION / UNHCR / LEVEL / END / AID / JAPANESE
general #4	DELEGATION / GROUP / DATE / SESSION / AGREEMENT / US / WISH / AIRCRAFT / AMBASSADOR / INTEREST
general #5	TAX / DEPT / SUBJECT / TIME / COMMERCIAL / REVIEW / POSITION / NEED / INCOME / OFFICE
general #6	GOVERNMENT / POLICY / SOVIET / TIME / WELL / US / DO / ROLE / FORCE / WASHDC
general #7	COMMITTEE / SECURITY / TEXT / LEBANESE / SPEECH / UNITED STATES / LANGUAGE / VOTE / IMPORTANT / GUINEA
general #8	TEXT / UNITED STATES / PERCENT / GOVERNMENT / EXPORT / ENERGY / YEAR / TOTAL / AGREEMENT / INCREASE
general #9	PROPOSAL / TIME / QUESTION / VIETNAM / UNQUOTE / POSITION / BORDER / USE / USG / CHARTER
general #10	MISSION / AID / PLEASE / ADVISE / DEPARTMENT / REQUEST / TRADE / GROUP / APPRECIATE / ADVANCE
general #11	AFRICA / AFRICAN / SOVIET / NAMIBIA / SECRETARY / CALL / BLACK / COMMITTEE / POSITION / SWAPO
general #12	GENERAL / PARTY / PEOPLE / SUPPORT / LAW / END / MINISTER / GOVERNMENT / SUMMARY / ROLE
general #13	US / COMMITTEE / JOINT / GROUP / PUERTO / BRAZIL / RICO / CHAIRMAN / CONTROL / VOTE
general #14	TOTAL / NUMBER / MILLION / RATE / EXCHANGE / OIL / NONE / DEBT / DOLLAR / DATE
general #15	AMERICAN / OFFICER / CONSULAR / SCHEDULE / TIME / ARRIVE / FLIGHT / LEAVE / EMBASSY / ONE
general #16	VISIT / TIME / PROGRAM / GENERAL / DIRECTOR / AIRCRAFT / TEAM / GOVERNMENT / PRIVATE / RESIDENCE
general #17	REFTEL / VISIT / APPRECIATE / INVITATION / DEPARTMENT / POST / SCHEDULE / TRAVEL / ATTEND / DO
general #18	EMBASSY / HOTEL / DEATH / VISIT / DEPART / REQUEST / PROGRAM / ARRIVE / SEMINAR / LOCAL
general #19	US / COMMITTEE / LEVEL / ASEAN / POSITION / USG / AGREEMENT / BELIEVE / THIRD / APPROACH
general #20	VISIT / QUOTE / DELEGATION / EMBASSY / REFTEL / SUPPORT / DEPARTMENT / PRESS / COMMITTEE / MEET
general #21	TIME / ONE / REF / PRICE / MAP / REQUEST / DATE / INTEREST / PROGRAM / RATE
general #22	AGREEMENT / US / DRAFT / RESOLUTION / TEXT / CANADIAN / CANADA / USDEL / LANGUAGE / ISSUE
general #23	VISIT / US / AMERICAN / ONE / AMBASSADOR / FRENCH / MEET / GENERAL / LIKE / AID
general #24	PROGRAM / PARTY / POST / CUBAN / WEEK / GENERAL / PRESS / AMBASSADOR / ARRIVAL / COMMENT
general #25	GOVERNMENT / PROJECT / FIRM / LETTER / DRUG / ACTION / ORDER / SERVICE / EQUIPMENT / ONE
general #26	US / TIME / ARAB / EGYPT / BELIEVE / POSITION / EGYPTIAN / KNOW / SIDE / ISRAELI
general #27	TRADE / POST / PRICE / COMMERCIAL / FISCAL / REQUEST / OIL / PROVIDE / MTN / MARKET
general #28	PARTY / REPORT / ONE / LETTER / STATEMENT / ELECTION / POLICY / LAST / COMMENT / SUPPORT
general #29	STATE / RESOLUTION / ARAB / COUNCIL / NATIONAL / NAM / UNITED NATIONS / SITUATION / REPUBLIC / CONCERN
general #30	SECRETARY / PRESS / GOVERNMENT / MINISTER / TEXT / AIRPORT / PRESIDENT / TRIP / PEOPLE / RETURN
general #31	PROGRAM / CASE / REQUEST / EMBASSY / AID / ONE / TAKE / MINISTRY / PLAN / BELIEVE
general #32	ISRAEL / PEACE / MIDDLE / SUPPORT / US / AMERICAN / LEBANON / POSITION / TODAY / QUOTE
general #33	SCHOOL / YEAR / PLAN / NUCLEAR / ZAIRE / PLANT / ENERGY / POWER / LEVEL / SOLAR
general #34	INVESTMENT / ANNUAL / PROGRAM / CONFERENCE / REPORT / COMMITTEE / TECHNOLOGY / REGIONAL / OECD / GROUP
general #35	PROJECT / ONE / OFFICER / F / EMBASSY / COST / DIRECTOR / DELIVERY / TIME / WATER
general #36	DIRECTOR / VISIT / EMBASSY / AMBASSADOR / REQUEST / FIRM / OPPORTUNITY / NEW YORK / TELEPHONE / BUSINESS
general #37	EMBASSY / MINISTRY / GROUP / DATE / REFTEL / TIME / CASE / ARRIVAL / OFFICE / PLEASE
general #38	END / YEAR / MILLION / FRENCH / BEGIN / PERIOD / USE / INTEREST / PRICE / SUPPLY
general #39	EMBASSY / CONTACT / COMPANY / APPRECIATE / DEPARTMENT / DEPT / PLANT / WATER / REPORT / REPRESENTATIVE
general #40	COMMITTEE / LETTER / SYSTEM / WORK / COUNCIL / SUPPORT / ACTION / UNITED STATES / ACT / ORDER
general #41	SOVIET / NUCLEAR / CHINA / CHINESE / SOVIET UNION / INDIA / FORCE / WAR / CONGRESS / PEACE
general #42	VISIT / US / MINISTER / ENERGY / SECRETARY / PRIME / POLICY / GROUP / DIRECTOR / DELEGATION
general #43	LETTER / STATE / PRESIDENT / GOVERNMENT / NOTE / OFFICE / AMBASSADOR / HUMAN / LAW / REPUBLIC
general #44	AGREEMENT / NUCLEAR / COMMISSION / CASE / GROUP / USE / MAKE / NEED / STATEMENT / MATTER
general #45	EQUIPMENT / INDUSTRY / BANK / COMMITTEE / LOAN / GOVERNMENT / FINANCE / EXPORT / REPORT / STUDY
general #46	BANK / MARKET / PERCENT / TAX / REFTEL / COMMERCE / SALE / USE / EXPORT / CONTRACT
general #47	PRESIDENT / TIME / CAR / DEPUTY / PRESS / SECRETARY / DO / ONE / PARTY / SESSION
general #48	MINISTRY / AGREEMENT / GOVERNMENT / UNITED STATES / POSITION / PRESIDENT / END / QUESTION / MINISTER / ONE
general #49	PERCENT / RATE / IMPORT / JAPANESE / YEAR / TRADE / DUTY / JAPAN / LAST / ONE
general #50	US / AIRCRAFT / PLAN / LOAN / AGRICULTURE / MILLION / USG / PURCHASE / CONTROL / BOARD
general #51	CONFERENCE / GENERAL / POLICY / GENEVA / REFTEL / END / SOVIET / WELL / ROLE / LINE
general #52	MILLION / CREDIT / COST / BANK / PERCENT / DIRECTOR / SYSTEM / STOCK / STATE / CONTRACT
general #53	ONE / ACTION / US / DATE / DECISION / LOCAL / PRESENT / REQUEST / COST / STAFF
general #54	SECRETARY / MINISTER / AMBASSADOR / MESSAGE / PRESIDENT / ASSISTANT / PRIME / DEPUTY / LE / OFFICE
general #55	GENERAL / RESOLUTION / SESSION / DELEGATION / MISSION / EFFORT / END / ORGANIZATION / TEXT / DECLARATION
general #56	US / SOVIET / BILATERAL / INTEREST / MOSCOW / ONE / JAPAN / THINK / WELL / STATEMENT
general #57	GOVERNMENT / MISSION / CONTRACT / CANDIDATE / LAST / DEPT / BUSINESS / UNITED STATES / LABOR / BELIEVE
general #58	ARRIVE / LONDON / DEPART / PLEASE / SCHEDULE / LOCAL / TRAVEL / NEW YORK / ROME / SECURITY
general #59	SECURITY / FRG / ISRAEL / BEIRUT / GERMAN / BERLIN / PLO / FRENCH / USE / SYRIAN
general #60	EQUIPMENT / AMERICAN / LOCAL / NUMBER / SECURITY / MARKET / POST / F / CONSTRUCTION / AREA
general #61	TRADE / LABOR / BANK / UNION / ILO / YEAR / INDUSTRY / END / INTEREST / INDUSTRIAL
general #62	MINISTER / COMMUNIST / ANTI / PARTY / ONE / SOVIET / DEFENSE / SIDE / COMMENT / PRESIDENT
general #63	TRAVEL / DEPARTMENT / CODEL / EMBASSY / FLIGHT / NEW YORK / STATE / FATHER / WIFE / TOUR
general #64	TIME / PORT / DAY / ARRIVAL / PERSONNEL / EMBASSY / WEEK / PROGRAM / UPON / GOP
general #65	REFTEL / YEAR / TOTAL / POST / MILLION / SUPPORT / MISSION / INCREASE / PLAN / EMBASSY
general #66	SECRETARY / VISIT / PRESIDENT / AMBASSADOR / DELEGATION / CALL / ASSISTANT / RETURN / SOVIET / TIME
general #67	US / GROUP / REPORT / STEEL / POSITION / USE / TAKE / PRESENT / PRESIDENT / SUBJECT
general #68	US / EMBASSY / PERSONNEL / SUBJECT / USE / STAFF / REFTEL / CASE / AMBASSADOR / POUCH
general #69	STUDY / REPORT / EMBASSY / AMERICAN / US / PROPOSAL / ONE / AMBASSADOR / CSCE / RESEARCH
general #70	CONFERENCE / PRESS / AMBASSADOR / PRESIDENT / GUIDANCE / VICE / GENEVA / MISSION / DO / ISSUE
general #71	JAN / TRAVEL / RESEARCH / PRODUCTION / GROUP / BOARD / ORDER / MATERIAL / BUSINESS / DEC
general #72	PRODUCTION / MILLION / PERCENT / AIRCRAFT / PRICE / MINISTRY / TOTAL / AGRICULTURE / BILLION / EXPORT
general #73	GOVERNMENT / GROUP / CONFERENCE / GENERAL / REPORT / BEGIN / PRESIDENT / MAKE / SITUATION / DELEGATION
general #74	LETTER / QUOTE / AMBASSADOR / UNQUOTE / MESSAGE / VISIT / UNITED STATES / NUCLEAR / FIRM / STATE
general #75	US / LETTER / POSITION / USG / COUNCIL / REPORT / DECISION / END / DATE / RHODESIA
general #76	ARTICLE / FORCE / REPORT / PERSONNEL / CONVENTION / SHALL / AIRCRAFT / MEDICAL / ARMY / LEGAL
general #77	STATE / COURT / REF / DEPARTMENT / REFTEL / STUDENT / POLICE / LETTER / LOCAL / CONSULATE
general #78	HUMAN / ARTICLE / DRAFT / TEXT / COMMISSION / SYSTEM / DO / PRESIDENT / ISSUE / LANGUAGE
general #79	CASE / TIME / GOVERNMENT / AGREEMENT / VIETNAMESE / VIETNAM / GOA / AID / BILATERAL / CONTINUE
general #80	NUMBER / STAFF / GENERAL / TOTAL / TRAFFIC / PROVIDE / ACTION / REQUEST / EMERGENCY / SECRETARIAT
general #81	ONE / VISIT / DEPARTMENT / CONFERENCE / DO / TIME / PLAN / POLICY / REF / WELL
general #82	AGREEMENT / TURKISH / CYPRUS / GREEK / TURKEY / TREATY / ISRAELI / QUESTION / ISRAEL / GREECE
general #83	US / CASE / REQUEST / ONE / USSR / QUOTE / WEEK / TRAVEL / DEPARTMENT / REPEAT
general #84	USG / US / SOVIET / POLICY / TIME / FRENCH / MINISTER / DECISION / COMMENT / EMBASSY
general #85	US / STATE / GOVERNMENT / SECRETARY / MATTER / AID / VIEW / LEVEL / QUESTION / CASE
general #86	OIL / PERCENT / INCREASE / PRICE / BANK / IMF / MILLION / CREDIT / PRESS / CRUDE
general #87	STATE / REF / GENERAL / TEAM / SITUATION / PROJECT / EQUIPMENT / ACTION / AMBASSADOR / MINISTER
general #88	AGREEMENT / US / STATE / PRESS / NUCLEAR / ISSUE / WEEK / ITALIAN / VIEW / GENERAL
general #89	REPORT / AMERICAN / ONE / PLEASE / MISSION / SECTION / CASE / STAFF / END / MINISTER
general #90	US / PROGRAM / USE / SEMINAR / REVIEW / APPRECIATE / DATE / REP / ACCEPTABLE / USG
general #91	ONE / CONFERENCE / DAY / NATIONAL / PARIS / ROOM / SHOW / THOUSAND / HUNDRED / HOTEL
general #92	SECURITY / POLICE / CONFERENCE / NATIONAL / PARTY / TIME / ONE / CIVIL / RADIO / LAW
general #93	US / DO / BELIEVE / MAKE / USG / SUPPORT / BRITISH / POSITION / ISSUE / TIME
general #94	EMBASSY / PROJECT / USG / REQUEST / REF / OPIC / NOTE / KOREAN / STATUS / APPROVAL
general #95	US / PROJECT / STATE / GROUP / ACTION / MEET / PARTICIPATION / REPORT / TECHNICAL / MAKE
general #96	CONFERENCE / COUNCIL / PROPOSAL / DO / SESSION / SOVIET / US / AGENDA / SUPPORT / STATEMENT
general #97	PROGRAM / UNIVERSITY / FOOD / AID / PRESIDENT / DEVELOPMENT / POST / PROFESSOR / DAY / ONE
general #98	GROUP / DEPT / REQUEST / PROPOSAL / REFTEL / CONTROL / END / PROGRAM / DOD / CHANGE
general #99	DEVELOPMENT / BUDGET / US / YEAR / FUND / MILLION / INCREASE / SYSTEM / ECONOMY / POLICY
